

  ##### #######
  ## ## ###  ##
  ####### ####
  #############
  ##  ### ####
  # ## ###### #
  ### $ #######
  # ### #  ## #
  #  ##### ####
