
               #########
          ###################
      ##########################
    ##############################
  ##################################
        ##################################
    ##################################
        #                    ###################################
  ##################################                  #
    ##################################   ##################################
 ####################################
 #################$##################
 ####################################
  ##################################
    ##############################
      ##########################
          ###################
               #########
