
  @@@@@ @@@@@@@
  @@ .@ @..  @@
  .@@@@@@ @@@@
  @@@@@@..@@@@.
  @.  @@@ @@@@
  @ .. #@@@@@ .
  @@@ $ #@@@@@@
  # @@@ #  @@ @
  #  ##### #@@@
   

