
  ..... ... .....
    . . .   .
  ... ....... . .
  .   .   .   . .
  ... . .........
  . . . .       .
  . . . ... ... .
  .   .   . .
  ... ... . .....
  .   .   @ .
  ... ... @@@ ...
    . .   # @ . .
  ... . ### @.. .
  .         @
  ... ######@@@@$
             

